7 7
30
WWWWWWW
WEe0D0W
WWWdW0W
WaWCWGW
WPW0WWW
WSAcbBW
WWWWWWW