15 15
120
WWWWWWWWWWWWWWW
W00000W00000W0W
W0W0WcW0WWW0W0W
W0W0WWWCW000W0W
W0W0W000W0WWW0W
W0W000W0WGW0W0W
W0WWWWWWWWW0W0W
W0W00000000000W
WPWWWW0000WWW0W
W0000WWW00WaW0W
WWWW0WbW00W0WPW
W0000W0W0000W0W
W0WWWW0WAWWWW0W
W00B00000WS000W
WWWWWWWWWWWWWWW