9 9
120
WWWWWWWWW
W0bWc0WdW
W0WWWBWCW
W00A00W0W
WWW0W000W
W000WWWDW
W0WPWaW0W
WSW000WGW
WWWWWWWWW